9 9 9 9 9 9 9 9 9 9 9 9 9 0 0 0 
9 4 4 4 4 3 2 3 4 4 4 4 9 0 0 1 
9 1 1 1 1 1 1 1 1 1 1 1 9 0 0 0 
9 1 1 1 1 1 1 1 1 1 1 1 9 0 0 0 
9 1 1 1 1 1 1 1 1 1 1 1 9 0 0 0 
9 9 9 9 9 9 9 9 9 9 9 9 9 0 0 0 
0 0 0 0 0 0 0 0 0 0 0 0 0 0 0 0 
0 0 0 0 0 0 0 0 0 0 0 0 0 0 0 0 
0 0 0 0 0 0 0 0 0 0 0 0 0 0 0 0 
0 0 0 0 0 0 0 0 0 0 0 0 0 0 0 0 
0 0 0 0 0 0 0 0 0 0 0 0 0 0 0 0 
0 0 0 0 0 0 0 0 0 0 0 0 0 0 0 0 
0 0 0 0 0 0 0 0 0 0 0 0 0 0 0 0 
0 0 0 0 0 0 0 0 0 0 0 0 0 0 0 0 
